###########################################################
#                           **                            #
# ******************************************************* #
#                           **                            #
######################      **       ######################
#                        #########                        #
# *******************                ******************** #
#                        #########                        #
######################      **       ######################
#                           **                            #
# ******************************************************* #
#                           **                            #
###########################################################
